XXXXXXXXXXXXXXXXXXX
XXXXXXXXXXXXXXXXXXX
XXXXXXXXXXXXXXXXXXX
X   X         X O X
X X X X X X X XOX X
X X X   X X   X X X
X X XXXXX XXXXX X X
X X X  OX X   X X X
X X X X XRX X X X X
X X O X BPY X   X X
X XXX XXX XXX XXX X
X     X    OX     X
X XXXXX XXX XXXXX X
X     X     X     X
XXXXX XXX XXX XXXXX
XO  X   X X   X   X
X X XXX XMX XXX X X
X X     X X     X X
X XXXXXXX XXXXXXX X
X                 X
XXXXXXXXXXXXXXXXXXX
